1 1 1 1 1 1 1 1 1 1 1 1 5 1 1 1 1 1 1 1 1 1 1 1 1 1 1 1
1 0 0 0 0 0 0 0 0 0 0 0 5 0 0 0 0 0 0 2 0 0 0 0 0 0 0 1
1 0 0 0 0 0 0 0 0 0 0 0 5 0 0 0 0 0 0 2 0 0 0 0 0 0 0 1
1 0 0 0 1 4 2 4 1 4 4 4 5 4 1 1 1 1 1 2 1 1 1 0 0 0 0 1
1 1 0 0 1 0 2 0 0 0 0 0 5 0 0 0 0 0 0 2 0 0 1 0 0 0 0 1
1 1 0 1 1 0 2 0 0 0 0 0 2 0 0 0 0 0 0 2 0 0 4 4 0 4 1 1
1 1 0 0 0 0 2 0 0 0 0 0 2 0 0 0 0 0 0 2 0 0 0 0 0 0 1 1
1 1 2 4 4 4 2 0 0 1 4 4 2 4 4 4 1 0 0 2 0 0 0 1 2 1 1 1
1 0 2 1 0 0 2 0 0 1 0 0 2 0 0 0 1 0 0 2 0 0 0 1 2 0 0 1
1 0 2 1 4 0 2 0 4 1 0 0 2 0 0 0 1 4 0 2 0 4 4 1 2 0 0 1
1 0 2 0 1 0 2 0 1 0 0 0 2 0 0 0 0 1 0 2 0 1 0 0 2 0 0 1
1 0 2 0 1 0 2 0 1 0 0 0 2 0 0 0 0 1 0 2 0 1 0 0 2 0 0 1
1 0 2 0 1 0 2 0 1 0 0 0 2 0 0 0 0 1 0 2 0 1 0 0 2 0 0 1
1 0 2 0 0 4 4 4 0 0 0 0 2 0 0 0 0 0 4 4 4 0 0 0 2 0 0 1
1 1 1 1 1 1 1 1 1 1 1 1 1 1 1 1 1 1 1 1 1 1 1 1 1 1 1 1
1 1 1 1 1 1 1 1 1 1 1 1 1 1 1 1 1 1 1 1 1 1 1 1 1 1 1 1
1 1 1 1 1 1 1 1 1 1 1 1 1 1 1 1 1 1 1 1 1 1 1 1 1 1 1 1