1 1 1 1 1 1 1 1 1 1 1 1 1 5 1 1 1 1 1 1 1 1 1 1 1 1 1 1
1 0 0 0 0 0 0 0 0 0 0 0 0 5 0 0 0 0 0 0 1 0 0 0 0 0 0 1
1 0 0 0 0 0 0 0 0 0 0 0 0 2 0 0 0 0 0 0 1 0 0 0 0 0 0 1
1 4 4 4 4 4 4 2 4 3 3 3 3 4 4 2 0 0 0 0 4 4 4 4 4 2 0 1
1 0 0 0 0 0 0 2 0 0 0 0 0 0 0 2 4 0 0 0 0 0 0 0 0 2 0 1
1 4 4 2 4 4 4 4 4 4 0 0 4 4 4 2 0 0 0 0 0 0 0 0 0 2 0 1
1 0 0 2 0 0 0 0 0 0 0 0 0 0 0 2 0 0 0 0 0 2 4 4 4 4 0 1
1 0 0 2 0 0 0 0 0 0 0 0 0 2 4 4 4 0 0 0 0 2 0 0 0 0 0 1
1 4 4 4 4 4 2 0 0 0 0 0 0 2 0 0 2 0 0 0 0 2 0 0 0 0 0 1
1 0 0 0 0 0 2 0 0 0 0 0 0 4 4 4 2 4 4 4 4 4 0 0 0 0 0 1
1 0 0 2 4 4 4 4 0 0 0 0 0 0 0 0 2 0 0 0 0 0 0 0 0 0 0 1
1 0 0 2 0 0 0 0 0 0 0 0 0 0 0 0 2 0 0 0 0 0 0 0 0 0 0 1
1 1 1 1 1 1 1 1 1 1 1 1 1 1 1 1 1 1 1 1 1 1 2 0 0 0 0 1
1 1 1 1 1 1 1 1 1 1 1 1 1 1 0 0 0 0 0 0 0 0 2 0 0 0 1 1
1 1 1 1 1 1 1 1 1 1 1 1 1 1 1 1 1 2 0 0 0 0 2 0 0 0 1 1
1 1 1 1 1 1 1 1 1 1 1 1 1 1 1 1 1 1 1 1 1 1 1 1 1 1 1 1
1 1 1 1 1 1 1 1 1 1 1 1 1 1 1 1 1 1 1 1 1 1 1 1 1 1 1 1